ALL : Albanian Lek
XCD : East Caribbean Dollar
EUR : Euro
BBD : Barbadian Dollar
BTN : Bhutanese Ngultrum
BND : Brunei Dollar
XAF : Central African CFA Franc
CUP : Cuban Peso
USD : United States Dollar
FKP : Falkland Islands Pound
GIP : Gibraltar Pound
HUF : Hungarian Forint
IRR : Iranian Rial
JMD : Jamaican Dollar
AUD : Australian Dollar
LAK : Lao Kip
LYD : Libyan Dinar
MKD : Macedonian Denar
XOF : West African CFA Franc
NZD : New Zealand Dollar
OMR : Omani Rial
PGK : Papua New Guinean Kina
RWF : Rwandan Franc
WST : Samoan Tala
RSD : Serbian Dinar
SEK : Swedish Krona
TZS : Tanzanian Shilling
AMD : Armenian Dram
BSD : Bahamian Dollar
BAM : Bosnia And Herzegovina Konvertibilna Marka
CVE : Cape Verdean Escudo
CNY : Chinese Yuan
CRC : Costa Rican Colon
CZK : Czech Koruna
ERN : Eritrean Nakfa
GEL : Georgian Lari
HTG : Haitian Gourde
INR : Indian Rupee
JOD : Jordanian Dinar
KRW : South Korean Won
LBP : Lebanese Lira
MWK : Malawian Kwacha
MRO : Mauritanian Ouguiya
MZN : Mozambican Metical
ANG : Netherlands Antillean Gulden
PEN : Peruvian Nuevo Sol
QAR : Qatari Riyal
STD : Sao Tome And Principe Dobra
SLL : Sierra Leonean Leone
SOS : Somali Shilling
SDG : Sudanese Pound
SYP : Syrian Pound
AOA : Angolan Kwanza
AWG : Aruban Florin
BHD : Bahraini Dinar
BZD : Belize Dollar
BWP : Botswana Pula
BIF : Burundi Franc
KYD : Cayman Islands Dollar
COP : Colombian Peso
DKK : Danish Krone
GTQ : Guatemalan Quetzal
HNL : Honduran Lempira
IDR : Indonesian Rupiah
ILS : Israeli New Sheqel
KZT : Kazakhstani Tenge
KWD : Kuwaiti Dinar
LSL : Lesotho Loti
MYR : Malaysian Ringgit
MUR : Mauritian Rupee
MNT : Mongolian Tugrik
MMK : Myanma Kyat
NGN : Nigerian Naira
PAB : Panamanian Balboa
PHP : Philippine Peso
RON : Romanian Leu
SAR : Saudi Riyal
SGD : Singapore Dollar
ZAR : South African Rand
SRD : Surinamese Dollar
TWD : New Taiwan Dollar
TOP : Paanga
VEF : Venezuelan Bolivar
DZD : Algerian Dinar
ARS : Argentine Peso
AZN : Azerbaijani Manat
BYR : Belarusian Ruble
BOB : Bolivian Boliviano
BGN : Bulgarian Lev
CAD : Canadian Dollar
CLP : Chilean Peso
CDF : Congolese Franc
DOP : Dominican Peso
FJD : Fijian Dollar
GMD : Gambian Dalasi
GYD : Guyanese Dollar
ISK : Icelandic Kr?na
IQD : Iraqi Dinar
JPY : Japanese Yen
KPW : North Korean Won
LVL : Latvian Lats
CHF : Swiss Franc
MGA : Malagasy Ariary
MDL : Moldovan Leu
MAD : Moroccan Dirham
NPR : Nepalese Rupee
NIO : Nicaraguan Cordoba
PKR : Pakistani Rupee
PYG : Paraguayan Guarani
SHP : Saint Helena Pound
SCR : Seychellois Rupee
SBD : Solomon Islands Dollar
LKR : Sri Lankan Rupee
THB : Thai Baht
TRY : Turkish New Lira
AED : UAE Dirham
VUV : Vanuatu Vatu
YER : Yemeni Rial
AFN : Afghan Afghani
BDT : Bangladeshi Taka
BRL : Brazilian Real
KHR : Cambodian Riel
KMF : Comorian Franc
HRK : Croatian Kuna
DJF : Djiboutian Franc
EGP : Egyptian Pound
ETB : Ethiopian Birr
XPF : CFP Franc
GHS : Ghanaian Cedi
GNF : Guinean Franc
HKD : Hong Kong Dollar
XDR : Special Drawing Rights
KES : Kenyan Shilling
KGS : Kyrgyzstani Som
LRD : Liberian Dollar
MOP : Macanese Pataca
MVR : Maldivian Rufiyaa
MXN : Mexican Peso
NAD : Namibian Dollar
NOK : Norwegian Krone
PLN : Polish Zloty
RUB : Russian Ruble
SZL : Swazi Lilangeni
TJS : Tajikistani Somoni
UGX : Ugandan Shilling
UYU : Uruguayan Peso
VND : Vietnamese Dong
TND : Tunisian Dinar
UAH : Ukrainian Hryvnia
UZS : Uzbekistani Som
TMT : Turkmenistan Manat
GBP : British Pound
ZMW : Zambian Kwac
BTC : Bitcoin
BYN : New Belarusian Ruble